111111111111
1PCE01111111
111111111111
